99
B00ST000A
N000000J0
00H000000
FV00P00XO
0K0000D00
G00000I00
000Q0000U
000C0000R
RMW00L00E